XXXXXXXXXXX
XS        X
XX X  X   X
XX X  XXXXX
X  X  X   X
X  X  X   X
X  X    X X
XXXX  XXX X
X  X    XXX
X  XX  XXEX
X   X     X
XXXXXXXXXXX
